きょうぷろ	競プロ	名詞	
さくもん	作問	名詞	
きしょう	椅嘯	名詞	
ひじめい	非自明	名詞	
あるご	アルゴ	名詞	
たほいや	たほいや	名詞	
りじょう	理情	名詞	
ぜんかん	全完	名詞	
はやとき	早解き	名詞	
さくもんしゃ	作問者	名詞	
きゅうかい	求解	名詞	
あさかい	朝会	名詞	
ぎじゅつしょてん	技術書典	固有名詞	
せぐき	セグ木	名詞	
そこてん	底点	名詞	
いんてつ	印哲	名詞	
ひじゅんかい	非巡回	名詞	
ひゃくり	百理	名詞	
ひゃくりある	百理ある	感動詞	
き	黃	抑制単語	
へいほうひじょうよ	平方非剰余	名詞	
そべき	素冪	名詞	
じょうほうぐん	乗法群	名詞	
ぶぶんぐん	部分群	名詞	
じゅんしすうじかん	準指数時間	名詞	
きょにじたい	虚二次体	名詞	
るいたこうしき	類多項式	名詞	
