a	あ
ba	ば
be	べ
bi	び
bo	ぼ
bu	ぶ
ca	か
ci	き
cu	く
ce	け
co	こ
da	だ
de	で
di	ぢ
do	ど
du	づ
e	え
fa	ぱ
fe	ぺ
fi	ぴ
fo	ぽ
fu	ぷ
ga	が
ge	げ
gi	ぎ
go	ご
gu	ぐ
ha	は
he	へ
hi	ひ
ho	ほ
hu	ふ
i	い
ma	ま
me	め
mi	み
mo	も
mu	む
n	ん
na	な
ne	ね
ni	に
nn	ん
no	の
nu	ぬ
o	お
p	ー
ra	ら
re	れ
ri	り
ro	ろ
ru	る
sa	さ
se	せ
si	し
so	そ
su	す
ta	た
te	て
ti	ち
to	と
tu	つ
u	う
va	や
vu	ゆ
vo	よ
wa	わ
we	ゑ
wi	ゐ
wo	を
za	ざ
ze	ぜ
zi	じ
zo	ぞ
zu	ず
'	っ
`a	ぁ
`i	ぃ
`u	ぅ
`e	ぇ
`o	ぉ
`ca	ヵ
`ce	ヶ
`wa	ゎ
`we	ゑ
`wi	ゐ
`va	ゃ
`vo	ょ
`vu	ゅ
`vs	ゃ
`vn	ょ
`vh	ゅ
;	あん
x	いん
k	うん
j	えん
q	おん
c;	かん
cx	きん
ck	くん
cj	けん
cq	こん
c'	かい
cy	くい
cp	くう
c.	けい
c,	こう
s;	さん
sx	しん
sk	すん
sj	せん
sq	そん
s'	さい
sy	すい
sp	すう
s.	せい
s,	そう
t;	たん
tx	ちん
tk	つん
tj	てん
tq	とん
t'	たい
ty	つい
tp	つう
t.	てい
t,	とう
n;	なん
nx	にん
nk	ぬん
nj	ねん
nq	のん
n'	ない
ny	ぬい
np	ぬう
n.	ねい
n,	のう
h;	はん
hx	ひん
hk	ふん
hj	へん
hq	ほん
h'	はい
hy	ふい
hp	ふう
h.	へい
h,	ほう
m;	まん
mx	みん
mk	むん
mj	めん
mq	もん
m'	まい
my	むい
mp	むう
m.	めい
m,	もう
r;	らん
rx	りん
rk	るん
rj	れん
rq	ろん
r'	らい
ry	るい
rp	るう
r.	れい
r,	ろう
w;	わん
wx	ゐん
wj	ゑん
wq	をん
w'	わい
w.	ゑい
w,	をう
v;	やん
vk	ゆん
vq	よん
v'	やい
vy	ゆい
vp	ゆう
v,	よう
g;	がん
gx	ぎん
gk	ぐん
gj	げん
gq	ごん
g'	がい
gy	ぐい
gp	ぐう
g.	げい
g,	ごう
z;	ざん
zx	じん
zk	ずん
zj	ぜん
zq	ぞん
z'	ざい
zy	ずい
zp	ずう
z.	ぜい
z,	ぞう
d;	だん
dx	ぢん
dk	づん
dj	でん
dq	どん
d'	だい
dy	づい
dp	づう
d.	でい
d,	どう
b;	ばん
bx	びん
bk	ぶん
bj	べん
bq	ぼん
b'	ばい
by	ぶい
bp	ぶう
b.	べい
b,	ぼう
f;	ぱん
fx	ぴん
fk	ぷん
fj	ぺん
fq	ぽん
f'	ぱい
fy	ぷい
fp	ぷう
f.	ぺい
f,	ぽう
cga	きゃ
cgi	きぃ
cgu	きゅ
cge	きぇ
cgo	きょ
cg;	きゃん
cgx	きぃん
cgk	きゅん
cgj	きぇん
cgq	きょん
cg'	きゃい
cgy	きゅい
cgp	きゅう
cg.	きぇい
cg,	きょう
sha	しゃ
shi	しぃ
shu	しゅ
she	しぇ
sho	しょ
sh;	しゃん
shx	しぃん
shk	しゅん
shj	しぇん
shq	しょん
sh'	しゃい
shy	しゅい
shp	しゅう
sh.	しぇい
sh,	しょう
tha	ちゃ
thi	ちぃ
thu	ちゅ
the	ちぇ
tho	ちょ
th;	ちゃん
thx	ちぃん
thk	ちゅん
thj	ちぇん
thq	ちょん
th'	ちゃい
thy	ちゅい
thp	ちゅう
th.	ちぇい
th,	ちょう
nha	にゃ
nhi	にぃ
nhu	にゅ
nhe	にぇ
nho	にょ
nh;	にゃん
nhx	にぃん
nhk	にゅん
nhj	にぇん
nhq	にょん
nh'	にゃい
nhy	にゅい
nhp	にゅう
nh.	にぇい
nh,	にょう
hna	ひゃ
hni	ひぃ
hnu	ひゅ
hne	ひぇ
hno	ひょ
hn;	ひゃん
hnx	ひぃん
hnk	ひゅん
hnj	ひぇん
hnq	ひょん
hn'	ひゃい
hny	ひゅい
hnp	ひゅう
hn.	ひぇい
hn,	ひょう
mva	みゃ
mvi	みぃ
mvu	みゅ
mve	みぇ
mvo	みょ
mv;	みゃん
mvx	みぃん
mvk	みゅん
mvj	みぇん
mvq	みょん
mv'	みゃい
mvy	みゅい
mvp	みゅう
mv.	みぇい
mv,	みょう
rga	りゃ
rgi	りぃ
rgu	りゅ
rge	りぇ
rgo	りょ
rg;	りゃん
rgx	りぃん
rgk	りゅん
rgj	りぇん
rgq	りょん
rg'	りゃい
rgy	りゅい
rgp	りゅう
rg.	りぇい
rg,	りょう
gra	ぎゃ
gri	ぎぃ
gru	ぎゅ
gre	ぎぇ
gro	ぎょ
gr;	ぎゃん
grx	ぎぃん
grk	ぎゅん
grj	ぎぇん
grq	ぎょん
gr'	ぎゃい
gry	ぎゅい
grp	ぎゅう
gr.	ぎぇい
gr,	ぎょう
zma	じゃ
zmi	じぃ
zmu	じゅ
zme	じぇ
zmo	じょ
zm;	じゃん
zmx	じぃん
zmk	じゅん
zmj	じぇん
zmq	じょん
zm'	じゃい
zmy	じゅい
zmp	じゅう
zm.	じぇい
zm,	じょう
dna	ぢゃ
dni	ぢぃ
dnu	ぢゅ
dne	ぢぇ
dno	ぢょ
dn;	ぢゃん
dnx	ぢぃん
dnk	ぢゅん
dnj	ぢぇん
dnq	ぢょん
dn'	ぢゃい
dny	ぢゅい
dnp	ぢゅう
dn.	ぢぇい
dn,	ぢょう
bva	びゃ
bvi	びぃ
bvu	びゅ
bve	びぇ
bvo	びょ
bv;	びゃん
bvx	びぃん
bvk	びゅん
bvj	びぇん
bvq	びょん
bv'	びゃい
bvy	びゅい
bvp	びゅう
bv.	びぇい
bv,	びょう
fra	ぴゃ
fri	ぴぃ
fru	ぴゅ
fre	ぴぇ
fro	ぴょ
fr;	ぴゃん
frx	ぴぃん
frk	ぴゅん
frj	ぴぇん
frq	ぴょん
fr'	ぴゃい
fry	ぴゅい
frp	ぴゅう
fr.	ぴぇい
fr,	ぴょう
hha	ふぁ
hhi	ふぃ
hhu	ふぅ
hhe	ふぇ
hho	ふぉ
hh;	ふぁん
hhx	ふぃん
hhk	ふぅん
hhj	ふぇん
hhq	ふぉん
hh'	ふぁい
hhy	ふぅい
hhp	ふぅう
hh.	ふぇい
hh,	ふぉう
vva	ゔぁ
vvi	ゔぃ
vvu	ゔ
vve	ゔぇ
vvo	ゔぉ
vv;	ゔぁん
vvx	ゔぃん
vvk	ゔぅん
vvj	ゔぇん
vvq	ゔぉん
vv'	ゔぁい
vvy	ゔぅい
vvp	ゔぅう
vv.	ゔぇい
vv,	ゔぉう
wwa	うぁ
wwi	うぃ
wwu	うぅ
wwe	うぇ
wwo	うぉ
ww;	うぁん
wwx	うぃん
wwk	うぅん
wwj	うぇん
wwq	うぉん
ww'	うぁい
wwy	うぅい
wwp	うぅう
ww.	うぇい
ww,	うぉう
hhna	ふゃ
hhnu	ふゅ
hhno	ふょ
vvma	ゔゃ 
vvmu	ゔゅ
vvmo	ゔょ
vvm;	ゔゃん
vvmk	ゔゅん
vvmq	ゔょん
vvm'	ゔゃい
vvmy	ゔゅい
vvmp	ゔゅう
vvm,	ゔょう
dha	でゃ
dhi	でぃ
dhu	でゅ
dhe	でぇ
dho	でょ
dh;	でゃん
dhx	でぃん
dhk	でゅん
dhj	でぇん
dhq	でょん
dh'	でゃい
dhy	でゅい
dhp	でゅう
dh.	でぇい
dh,	でょう
tna	てゃ
tni	てぃ
tnu	てゅ
tne	てぇ
tno	てょ
tn;	てゃん
tnx	てぃん
tnk	てゅん
tnj	てぇん
tnq	てょん
tn'	てゃい
tny	てゅい
tnp	てゅう
tn.	てぇい
tn,	てょう
fc	ぴゅう
fl	ぴょう
gc	ぎゅう
gl	ぎょう
cc	きゅう
cl	きょう
rc	りゅう
rl	りょう
ht	ひゅう
hs	ひょう
tt	ちゅう
ts	ちょう
nt	にゅう
ns	にょう
st	しゅう
ss	しょう
bw	びゅう
bz	びょう
mw	みゅう
mz	みょう
zw	じゅう
zz	じょう
frg	ぴゅく
frr	ぴょく
frl	ぴゃく
frc	ぴゅつ
grg	ぎゅく
grr	ぎょく
grl	ぎゃく
grc	ぎゅつ
cgg	きゅく
cgr	きょく
cgl	きゃく
cgc	きゅつ
rgg	りゅく
rgr	りょく
rgl	りゃく
rgc	りゅつ
dnh	ぢゅく
dnn	ぢょく
dns	ぢゃく
dnt	ぢゅつ
hnh	ひゅく
hnn	ひょく
hns	ひゃく
hnt	ひゅつ
thh	ちゅく
thn	ちょく
ths	ちゃく
tht	ちゅつ
nhh	にゅく
nhn	にょく
nhs	にゃく
nht	にゅつ
shh	しゅく
shn	しょく
shs	しゃく
sht	しゅつ
bvm	びゅく
bvv	びょく
bvz	びゃく
bvw	びゅつ
mvm	みゅく
mvv	みょく
mvz	みゃく
mvw	みゅつ
zmm	じゅく
zmv	じょく
zmz	じゃく
zmw	じゅつ
cfa	かつ
cfi	きつ
cfu	くつ
cfe	けつ
cfo	こつ
sda	さつ
sdi	しつ
sdu	すつ
sde	せつ
sdo	そつ
tda	たつ
tdi	ちつ
tdu	つつ
tde	てつ
tdo	とつ
nda	なつ
ndi	ぬつ
ndu	につ
nde	ねつ
ndo	のつ
hda	はつ
hdi	ひつ
hdu	ふつ
hde	へつ
hdo	ほつ
mba	まつ
mbi	みつ
mbu	むつ
mbe	めつ
mbo	もつ
rfa	らつ
rfi	りつ
rfu	るつ
rfe	れつ
rfo	ろつ
wba	わつ
wbi	ゐつ
wbe	ゑつ
wbo	をつ
vba	やつ
vbu	ゆつ
vbo	よつ
gfa	がつ
gfi	ぎつ
gfu	ぐつ
gfe	げつ
gfo	ごつ
zba	ざつ
zbi	じつ
zbu	ずつ
zbe	ぜつ
zbo	ぞつ
dda	だつ
ddi	ぢつ
ddu	づつ
dde	でつ
ddo	どつ
bba	ばつ
bbi	びつ
bbu	ぶつ
bbe	べつ
bbo	ぼつ
ffa	ぱつ
ffi	ぴつ
ffu	ぷつ
ffe	ぺつ
ffo	ぽつ
cf'	かく
cfy	きく
cfp	くく
cf.	けく
cf,	こく
sd'	さく
sdy	しく
sdp	すく
sd.	せく
sd,	そく
td'	たく
tdy	ちく
tdp	つく
td.	てく
td,	とく
nd'	なく
ndy	ぬく
ndp	にく
nd.	ねく
nd,	のく
hd'	はく
hdy	ひく
hdp	ふく
hd.	へく
hd,	ほく
mb'	まく
mby	みく
mbp	むく
mb.	めく
mb,	もく
rf'	らく
rfy	りく
rfp	るく
rf.	れく
rf,	ろく
wb'	わく
wby	ゐく
wb.	ゑく
wb,	をく
vb'	やく
vbp	ゆく
vb,	よく
gf'	がく
gfy	ぎく
gfp	ぐく
gf.	げく
gf,	ごく
zb'	ざく
zby	じく
zbp	ずく
zb.	ぜく
zb,	ぞく
dd'	だく
ddy	ぢく
ddp	づく
dd.	でく
dd,	どく
bb'	ばく
bby	びく
bbp	ぶく
bb.	べく
bb,	ぼく
ff'	ぱく
ffy	ぴく
ffp	ぷく
ff.	ぺく
ff,	ぽく
cf;	かっ
cfx	きっ
cfk	くっ
cfj	けっ
cfq	こっ
sd;	さっ
sdx	しっ
sdk	すっ
sdj	せっ
sdq	そっ
td;	たっ
tdx	ちっ
tdk	つっ
tdj	てっ
tdq	とっ
nd;	なっ
ndx	にっ
ndk	ぬっ
ndj	ねっ
ndq	のっ
hd;	はっ
hdx	ひっ
hdk	ふっ
hdj	へっ
hdq	ほっ
mb;	まっ
mbx	みっ
mbk	むっ
mbj	めっ
mbq	もっ
rf;	らっ
rfx	りっ
rfk	るっ
rfj	れっ
rfq	ろっ
wb;	わっ
wbx	ゐっ
wbj	ゑっ
wbq	をっ
vb;	やっ
vbk	ゆっ
vbq	よっ
gf;	がっ
gfx	ぎっ
gfk	ぐっ
gfj	げっ
gfq	ごっ
zb;	ざっ
zbx	じっ
zbk	ずっ
zbj	ぜっ
zbq	ぞっ
dd;	だっ
ddx	ぢっ
ddk	づっ
ddj	でっ
ddq	どっ
bb;	ばっ
bbx	びっ
bbk	ぶっ
bbj	べっ
bbq	ぼっ
ff;	ぱっ
ffx	ぴっ
ffk	ぷっ
ffj	ぺっ
ffq	ぽっ
-	ー
~	〜
.	。
,	、
`/	・
`.	…
`,	‥
`-	〜
`[	『
`]	』
[	「
]	」
`h	←
`j	↓
`k	↑
`l	→
cz	⋯⋯
cd	←
ch	↓
ct	↑
cn	→
cra	ぁ
cri	ぃ
cru	ぅ
cre	ぇ
cro	ぉ
crva	ゃ
crvu	ゅ
crvo	ょ
crca	ヵ
crce	ヶ
crwa	ゎ
crtu	っ
